################
#--##--##---#--#
#-----##--#----#
#-###-----###-##
###---#-#---####
##--#-###-#---##
#--###-#--###--#
##-##--#--##--##
#---#-###--#-###
#-#-----#----###
#-#---#-#--#-#-#
#####-#-#-##---#
#---#----##--#-#
#-#-#-##----##-#
#-#---#--##----#
################