----------------
| |            |
| |            |
| |            |
| |            |
| |            |
| |            |
| |______      |
|  ______      |
|              |
|              |
|              |
|              |
|              |
|              |
----------------